20
.@.......@.......@..
.@..............@@..
.............@......
...............@....
.@..................
.................@..
....................
.......@........@...
.....@...@....@.....
....................
....................
.....@@......@......
...................@
....@.@.............
..@........@........
.@..................
.............@..@...
....................
....@..........@....
...............@.@.@
